А а 	A a
Б б 	B b
В в 	V v
Г г 	G g
Д д 	D d
Е е 	Ye ye, E e (*)
Ж ж 	Zh zh
З з 	Z z
И и 	I i
Й й 	Y y
К к 	K k
Л л 	L l
М м 	M m
Н н 	N n
О о 	O o
П п 	P p
Р р 	R r
С с 	S s
Т т 	T t
У у 	U u
Ф ф 	F f
Х х 	Kh kh
Ц ц 	Ts ts
Ч ч 	Ch ch
Ш ш 	Sh sh
Щ щ 	Shch shch
Ъ ъ 	"
Ы ы 	y
Ь ь 	'
Э э 	E e
Ю ю 	Yu yu
Я я 	Ya ya